11111111111111111111111111
10000000000000000001000001
10000000000000000001000C01
10000000000000000000000001
10000000000000000001000001
10001111001111000001111111
10001000000001000000000001
10001000000001000000000001
10P010C0000001000000000E01
11111111111111111111111111