11111111111111111111111111
10000000000000000001000001
10000000000000000001000001
1000000000000000000000C001
10000000000000000001000001
10001111100111000001111111
10001000000001000000000001
10001000000001000000000001
10P010C000000100000000E001
11111111111111111111111111