111111111111111111111111111111
1P100000000000000000C0000001C1
101110111111011111011111011101
100010000001000000010000010001
101011111101111110111110111101
101000000001000000010000000001
101011111101011111111101111101
101000000001000000000001000001
101111110111011111111101011101
100000010000000C00000001000001
101110110111011111011111111101
1000000000010000010000000000E1
111111111111111111111111111111