1111111111111111111111111111111111111
1P00000000000000000000000000000000001
1011111011111011111011101111101111101
1010000010000010000010000000100000101
1010111110111110111110111111101111101
1010000010000000000010000000001000001
1011111011111011111011111011111011101
1000000010000010000000000010000000001
1111101111111011111011111011111011111
1C000100000010000000000000000000000E1
1011101111101111101111101111111111101
1000000000000000000000000000000000001
1011111011111011111011111011111011111
1000001000001000001000000000000000001
1011111011101111111011111011111111101
1000000000100000000000000000000000C01
1111101111101111101111111111111111101
1C000000000000000000000000000000000E1
1011111011111011111011111011111111101
100000000000C0000000C0000000000000001
1111111111111111111111111111111111111