111111111111111111111111111
1P0000000000000000000000001
101111111101111111110111101
10100C001001000000C1010C101
101011101111011111110101101
101000100000010000000101101
101110101111011111110101101
100000101000010000000100001
111111101111011111110111101
1C000000100C00000000000E001
111111111111111111111111111